11111111111111111111111111111111111111111111111111
1P000000000000000000000000000C00000000000000000001
10111011110111101111011110111101111011110111101101
100000C0000000000000000000000000000000000000000001
10000000000000000000000000000000000000000000000001
10000000C00000000000000000000000000000000000000001
10111011110111101111011110111101111011110111101101
10000000000000000000000000000000000000000000000001
100000000000000000000000000C0000000000000000000001
10000000000000000000000000000000000000000000000001
10111011110111101111011110111101111011110111101101
100000C0000000000000000000000000000000000000000001
100000000000000000000000000000C0000000000000000001
10000000000000000000000000000000000000000000000001
10111011110111101111011110111101111011110111101101
10000000000000000000000000000000000000000000000001
10000000000000000000000000000000000000000000000001
100000000C0000000000000000000000000000C00000000001
10111011110111101111011110111101111011110111101101
100C00000000000000C0000C00000000000000000000000001
10000000000000000000000000000000000000000000000001
100000000000000000000000000000000C0000000000000001
10111011110111101111011110111101111011110111101101
1000000000000000000000000000000C000000000000000001
100000000000000000000000C0000000000000000000000001
10000000000000000000000000000000000000000000000001
10111011110111101111011110111101111011110111101101
10000000000000000000000000C00000000000000000000001
10000000000000000000000000000000000000000000000001
1000000000000000000000000000000C000000000000000001
101110111101111011110111101111011110111101111011C1
10000000000000000000000000000000000000000C00000001
10C0000C0000000000000000000000000000000000000C0001
10000C000000000000000000C0000000000000000000000001
1C111011110111101111011110111101111011110111101101
100000000000000000000C00000000C0000000000000000001
100000000C0000000C00000000000000000000000000000001
100000000000000000000000000C0000000000000000000001
10111011110111101111011110111101111011110111101101
10000000000000000000000000000000000000000000000001
10000000000000000000000C00000000000000000000000001
100000000000000000000000000000C0000000000000000001
101110111101111C1111011110111101111011110111101101
10000000000000000C000000000000000000C0000000000001
100C000000000000C000000000000000C00000000000000001
10000C00000000000000000000000000000000000000000001
10111011110111101111011110111101111011110111101101
100000000000000000000000000C0000000C00000000000001
100000000000000000000000000000000000000000000000E1
11111111111111111111111111111111111111111111111111