111111111
10P011011
111T11011
11CE00001
100000001
111000001
110000001
111111111