1111111111111111111111111111111111111111111111111111111111111111111111111111111111111111111111111111
1P000000000000000000000000000000000000000000000000000000000000000000000000000C0000000000000000000001
1000000000000000000000000000000000000000000000000000000000000000000000000000000000000000000000000001
10000000000000000000000000000000000000000000000000000C0000000000000000000000000000000000000000000001
100000000000C000000000000000000000000000000000000000000000000000000000000000000000000000000000000001
1000000000000000000000000000000000000000000000000000000000000000000000000000000000000000000000000001
1000000000000000000000000000000000000000000000000000000000000000000000000000000000000000000000000001
10000000000000000000000000000000000000000000000000000000C0000000000000000000000000000000000000000001
1000000000000000000000000000000000000000000000000000000000000000000000000000000000000000000000000001
1000000000000000000000000000000000000000000000000000000000000000000000000C0000000C000000000000000001
10000000000000000000000000000000000000000000000000000000000000000000C0000000000000000000000000000001
100000000000000000000000000000000000000000000000000000000C0000000000C0000000000000000000000000000001
1000000000000000000000000000000000000000000000000000000000000000000000000000000000000000000000000001
1000000000000000000000000000000000000000000000000000000000000000000000000000000000000000000000000001
100000000000000000000000000000000000000000000000000000000000000000000000000000000C000000000000000001
1000000000000000000000000000000000000000C000000000000000000000000000000000000000C0000000000000000001
1000000000000000000000000000000000000000000000000000000000000000000000000000000000000000000000000001
1000000000000000C0000000000000000C00000000000000000000C0000C0000000000000000000000000000000000000001
100000000000000000000000000C0C0000000000000000000000000000000000000000000000000000000000000000000001
1000000000000000000000000000000000000000000000000000000000000000000000000000000000000000000000000001
1000000000000000000000000000000000000000000000C000000000000000000000000000000000000000000000000000C1
10000000000000000000000000000000000000C0000000000000000000000000000000000000000000000000000000000001
1000000000000000000000000000000000000000000000000000000000000000000000000000000000000000000000000001
10000000000000000000000000C00000000000000000000000000000000000000000000000000000000000000000C0000001
10000C0C000000000000000000000000000000000000000000000000C0000000000000000000000000000000000000000C01
10000000000000000000000000000000000000000000000000000000000000000000000000000000000000000000000C0001
100000000000000000000000000000000000000000000C000000000000C00000000000000000000000000000000000000001
1000000000000000000000000000000000000000000000000000000000000000000000000000000000000000000000000001
1000000000000000000000000000000000000000000000000000000000000000000000000000000000000000000000000001
1000000000000000000000000000000000000000000000000000000000000000000000000000000000000000000000000001
100000000000000000000000000000C000000000000000000000000000000000000000000000000000000000000000000001
1000000000000000000000000000000000000000000000000000000000000000000000000000000000000000000000000001
100000000000000000000000000000000000000000000000000000000000000000000000000000000000000000000C000001
10000000000000000C000000000000000000000000000000000000000000C000000000000000000000000000000000C00001
1000000000000000000000000000000000000000000000000000000000000000000000000000000000000000000000000001
1000000000000000000000000000000000000000000000000000000000000000000000000000000000000000000000000001
10000000000000000000000000000000000000000000000000000000000000000000000000000000000000000C0000000001
10000000000000000000000000000000000000000000000000000000000000000000000000000000000000000000000C0001
10000000000000000000000000000000000000000000000000000000000000000000000C0000000000000000000000000001
100C000000000000000000000000000000000000000000000000000000000000000000000000C00000000000000000000001
100000C0000000000000000000000000000000000000C0000000000000000000000000000000000000000000000000000001
1000000000000000000000000000000000000000000000000000000000000000000000000000000000000000000000000001
1000000000000000000000000000000000000000000000000000000000000000000000000000000000000000000000000001
1000000000000000000000000000000000C000000000000000000000000000000000000000000000000C0000000000000001
10000000000000000000000000000000000000000000000000000000000000000000000000000000000C0000000000000001
1000000000000000000000000000C0000000000000000000000000000000C0000000000000000000000000000000000C0001
1000000C0000000000000000000000000000000000000000000000C000000000000000000000000000000000000000000001
1000000000000000000000000000000000000000000000000000000000000000000000000000000000000000000000000001
1000000000000000000000000000000000000000000000000000000000000000000000000000000000000000000000000001
1000000000000000000000000000000000000000000000000000000000000000000000000000000000000000000000000001
1000000000000000000000000000000000000000000000000000C00000000000000000000C00000000000000000000000001
10000000000000000000000000C0000000000000C0000000000000000000000000000000000000000000000000000000C001
10000000000000000000000000000000000000000000000000000000000000000000000000C0000000000000000000000001
1000000000000000000000000000000000000000000000000C00000000000000000000000000000000000000000000000001
1000000000000000000000000000000000000000000000000000000000000000000000000000000000000000000000000001
1000000000000000000000000000000000000000000000000000000000000000000000000C0000000000000000000000C001
1000000000000000000000000000000000000000000000000000000000000000000000C00000000000000000000000000001
1000000000000000000000000000000000000000000000000000000000000000000000000000000000000000000000000001
1C00000000000000000000000000C00000000000000000C00000000000000000000000000000000000000000000000000001
1000000000000000000000000000000000000000000000000000000000000000000000000000000000000000000000000001
100000000000000000000000000000000000000000000000000000000000000000000000000000C00000000C000000000001
1000000000000000000000000000000000000000000000000000000000000000000000000000000000000000000000000001
1000000000000000000000000000000000000000000000000000000000000000000000000000000000000000000000000001
100000000000000000000000000000000000000000000000000000000000000000000C000000000000000000000000000001
1000000000000000000000000000000000000000000000000000C00000000000000000000000000000000C00000000000001
1000000000000000000000000000000000000000000000000000000000000000000000000000000000000000000000000001
1000000000000000000000000000000000000000000000000000000000000000000000000000000000000000000000000001
100000000000C000000000000000000000000000000000000000000000000000000000000000000000000000000000000001
1000000000000000000000000000000000000000000000000000000000000000000000000000000000000000000000000001
100000000000000000000000000000000C000000000000C0000000C000000000000000000000000000000000000000000001
100000000000000000000000000000000000000000000000000000C000000000000000000000000000000000000000000001
10000000000000000000000000000C000C000000000000000000000000000000000000000000C00000000000000000000001
1000000000000000000000000000000000000000000000000000000000000000000000000000000000C00000000000000001
100C000000000000000000000000C00000000000000000000000000000000000000000000000000000000000000000000001
1000000000000000000000000000000000000000000000000000000000000000000C00000000000000000000000000000001
100000000000000000000000000000000000000000000000000000000000000000000000000000000000C000000000000001
100000000000000000000000000000000000000000000000000000C000000000000000000000000000000000000000000C01
1000000000000000000000000C00000000000000000000000000000000000000000000000000000000000000000000000001
1000000000000000000000000000000000000000000000000000000000000000000000000000000000000000000000000001
1000000000000000000000000000000000000000000000000000000000000000000000000000000000000000000000000001
100000000000000000000000000000000000000000000000000000C000000000000000000000000000000000000000000001
1000000000000000000000000000000000000000000000000000000000000000000000000000000000000000000000000001
10000000000000000000000000000000000C0000000000000000000000000000000000000000000000000000000000000001
100000000000C0000C0000000000000000C0000000000000000000000000000000000000000000000000000C000000000001
1000000000000000000000000000000000000000000000000000C00C00000000000000000000000000000000000000000001
100000000000000000000000000000000000000000000000000000000000000000000000000000000000000000000C000001
100000000000000000000000000000000C000000000000000000000000000000000000000000000000C00000000000000001
100000000000000000000000000000000000000000000000000000000000000000000000000C000000000000000000000001
1000000000000000000000000000000000000000000000000000000000000000000000000000000000000000000000000001
1000000000000000000000000000000000000000000000000000000000000000000000000000000000000000000000000001
100000000000000000000000000000000000000000000000000000000000000C000000000000000000000000000000000001
1000000000000000000000000000000000000000000000000000000000000000000000000000000000000000000000000001
1000000000000000000000000000000000000000000000000000000000000000000000000000000000000000000000000001
10000000000000000000000000000000000000000000000000000000000000000000000000000000000000000000C0000001
1000000000000000000000000000000000000000000000000000000000000000000000000000000000000000000000000001
10000000000000000000000000000000000000000000000000000000000000000C0000000000000000000000000000000001
1000000000000000000000000000000000000000000000000000000000000000000000000000000000000000000000000001
1000000000000000000000000000000000000000000000000000000000000000000000000000000000000000000000000001
100000000000000000000000000000000000000000000000000000000000000000C0000000000000000000000000000000E1
1111111111111111111111111111111111111111111111111111111111111111111111111111111111111111111111111111