1111111111111111111111111111111111111111111111111111111111111111111111111111111111111111111111111111
1P0000000000000000C00000000000000000000C000000000000000000000000000000000000000000000000000000000001
1011111011111101111110111111011111101111110111111011111101111110111111011111101111110111111011111101
10000000000000000000000000000000000000000000000000000000000000000000000000000000000000000000000C0001
1000000000000000000000000000000000000000000000000000000000000000000000000000000000000000000000000001
100000000000000000000C00000000000000000000000000000C0000000000000000000000000000000000C0000000000001
1011111011111101111110111111011111101111110111111011111101111110111111011111101111110111111011111101
1000000000000000000000000000000000000000000000000000000000000000000000000000000000000000000000000001
10000000000000000000000000000000000000000000000000000000000000000000000000000C0000000000000000000001
100000000000000000C000000000000000000000000000000000000000000000000000000000000000000000000000000001
10111110111111011111101111110111111011111101111110111111C1111110111111011111101111110111111011111101
1C000000000000000C0000000000000000000000000000000000000000000000000000000000000000000000000000000001
100000000000000000000000000000000000000000000000000000000000000C000000000000000000000000000000000001
1000000000000000000000000000000000000000000000000000000000000000000000000000000000000000000000000001
1011111011111101111110111111011111101111110111111011111101111110111111011111101111110111111C11111101
100000000000000000000000000000000C0000000C000000000000000000000000000000000000000000C000000000000001
1000000000000000000000000000000000000000000000000000000000000000000000000000000000000000000000000001
1000000000000000000000000000C00000000000000000000000000000000000000000000000000000000000000000000001
1011111011111101111110111111011111101111110111111011111101111110111111011111101111110111111011111101
1000000000000000000000000000000000000000000000000000000000000000000000000000000000000000000000000001
1000000000000000000000000000000000000000000000000000000000000000000000000000000000000000000000000001
1000000000000000000000000000000000C0000000000000000000000000000000000000C000000000000000000000000001
1011111011111101111110111111011111101111110111111011111101111110111111011111101111110111111011111101
10000000000000000000000000000000000000000000000000000000000000000000000000000000000000C0000000000001
10000000000000000000000000000000000000000000000000000000000000000000000000000000000000000000C0000001
1000000000000000000000000000000000000000000000000000000000000000000000000000000000000000000000000001
1011111011111101111110111111011111101111110111111011111101111110111111011111101111110111111011111101
10000000000000000000000000000000000000000000000000000000000000000000000000000000C0000000000000000001
1000000000000000000000000000000000000000000000000000000000000000000000000000000000000000000000000001
1000000000000000000000000000000000000000000000000000000000000000000000000000000000000000000000000001
1011111011111101111110111111011111101111110111111011111101111110111111011111101111110111111011111101
10000000000000000000000000000000000000000000000CC00CC00000000000000000000000000000000000000000000001
1000000000000000000000000000000000000000000000000000000000000000000000000000000000000000000000000001
100C0000000000000000000000000000000000000000000000000000C00000000000000000000000C0000000000000000001
1011111011111101111110111111011111101111110111111011111101111110111111011111101111110111111011111101
10000000000000000000000000000000000000000000000000000000000000000000000000000000000000000000000C0001
1000000000000000000000000000000000000000000000000000000000000000000000000000000000000000000000000001
10000000000000000000000000000000000C0000000000000000000000000000000000000000000000000000000000000001
1011111011111101111110111111011111101111110111111011111101111110111111011111101111110111111011111101
100000000000000000000000000000000000000000C000000000000000000000000000000000000000000000000000000001
1000000000000000000000000000000000000000000000000000000000000000000000000000000000000000000000000001
100000000000000000000000000000000000000000000000C000000000000000000000000000000000000000000000000001
1011111011111101111110111111011111101111110111111011111101111110111111011111101111110111111011111101
10C000000000000000000000000000000000C000000000000000000000000000000000000000000000000000000000000001
1000000000000000000000000000000000000000000000000000000000000000000000000000000000000000000000000001
100000000000000000000000000000000000000000000000000000000000000000000000000000000000000000000000C001
1011111011111101111110111111011111101111110111111011111101111110111111011111101111110111111011111101
10000000000000000000000000000000000000000000000C000000000000000000000C000000000000000000000000000001
1000000000000000000000000000000000000000000000000000C00000000000000000000000000000000000000000000001
1000000000000000000000000000000000000000000000000000000000000000000000000000000000000000000000000001
1011111011111101111110111111011111101111110111111011111101111110111111011111101111110111111011111101
1000000000000000000000000000000000000000000000000000C00C00000000000000000000000000000000000000000001
10000000000000000000000000000000000000000000000C0000000000000000000000000000000000000000000000000001
1000000000000000000000000000000000000000000000000000000000000000000000000000000000000000000000000001
1011111011111101111110111111011111101111110111111011111101111110111111011111101111110111111011111101
1000000C0C000000000000000000000000000000000000000000000000000000000000000000000000000000000000000001
1000000000000000C000000000000000000000000000000000000000000000000000000000000000000000000000C0000001
100000000000000000000000C000000000000000000000000000000000000000000000000000000000000000000000000001
1011111011111101111110111111011111101111110111111011111101111110111111011111101111110111111011111101
100000000000000000000000000C0000C0000000000000000000000000000000000000000000000000000000000000000001
1000000000000000000000000000000000000000000000000000000000000000000000000000000000000000000000000001
1000000000000000000000000000000000000000000000000000000000000000000000000000000000000000000000000001
1011111011111101111110111111011111101111110111111011111101111110111111011111101111110111111011111101
1000000000000000000000000000000000000000000000000000000000000000000000000000000000C00000000000000001
10000000000000000000000000000000000C0000000000000000000000000000000000000000000000C00000000000000001
1000000000000000000000000000000000000000000000000000000000000000000000000000000C0000000C000000000001
1011111011111101111110111111011111101111110111111011111101111110111111011111101111110111111011111101
10000000000000000000000000000000C00C0000000000000000000000000000000000000000000000000000000000000001
1000000000000000000000000000000000000000000000000000000000000000000000000000000000000000000000000001
1000000000000000000000000000000000000000000000000000000000000000000000000000000000000000000000000001
101111101111110111111C111111011111101111110111111011111101111110111111011111101111110111111011111101
1000000000000000000000000000000000000000000000000000000000000000000000000000000000000000000000000001
100C00000000000000000000000000000000000000000000000000C000000000000000000000000000000000000000000001
10000000000000000000000000000000000000000000000000000000000000000000000000000000000000000000000C0001
1011111011111101111110111111011111101111110111111011111101111110111111011111101111110111111011111101
1000000000000000000000000000000000000000000000000000000000000000000000000000000000000000000000000001
1000000000000000000000000000000000000000000000000000000000000000000000000000000000000000000000000001
100C00000000000000000000000000000000000000000000000000C000000000000000000000000000000000000000000001
1011111011111101111110111111011111101111110111111011111101111110111111011111101111110111111011111101
1000000000000000000000000000000000000000000000000000000000000000000000000000000000000000000000000001
1000000000000000000000000000000000000000000000000000000000000000000000000000000000000000000000000001
1000000000000000000000000000000000000000000000C000000000000000C0000000000000000000000000000000000001
101111101111110111111C111111011111101111110111111011111101111110111111011111101111110111111011111101
1000000000000000000000000000000000000000000000000000000000000000000000000000000000000000000000000001
1000000000000000000000000000000000000000000000000000000000000000000000000000000000000000000000000001
1000000000000000000000000000000000000000000000000000000000000000000000000000000000000000000000000001
1011111011111101111110111111011111101111110111111011111101111110111111011111101111110111111011111101
1000000000000000000000000000C0000000000000000000000000000000000C000000000000000000000000000000000001
1000000000000000000000000000000000000000000000000000000000000000000000000000000000000000000000000001
100000C000000000000000000000000000000000000000000000000000000000000000000000000000000000000C00000001
1011111011111101111110111111011111101111110111111011111101111110111111011111101111110111111011111101
100000000000000000000000000000000000000000000000000000000000000000000000000000C000000000000000000001
100000000000000000000000000000000000000C0000000000000000000C0000000000000000000000000000000000000001
10C0000000000000000000000000000000000000000000000000000000000000000000000000000000000000000000000001
1011111011111101111110111111011111101111110111111C11111101111110111111011111101111110111111011111101
10000000000000000000000000000000C0000000000000000000000000000000000000000000000000000000000000000001
100000000000000000000000000000000000C0000000000C0000000000000000000000000000000000000000000000000001
10000000000000000000000000000000000000000000000000000000000000000000000C0000000000000000000000000001
1000000000000000000000000000000000000000000000000000000000000000000000000000000000000000000000C000E1
1111111111111111111111111111111111111111111111111111111111111111111111111111111111111111111111111111