111111111111111111111111111111
1P0000000000000000000000000001
101101110111011101110111011101
100000000000000000000000000001
1000000T0000000000T00000000001
100000000000000000000000000001
101101110111011101110111011101
100000000000000000000000000001
100000000000T00000000000000001
100000000000000000000000000001
101101110111011101110111011101
100000000000000000000000000001
1000000T0000C0000C000000000001
1000000T0000000000000000000001
101101110111011101110111011101
100000000000000000000000000001
100000000000000T00000000000001
100000000000000000000000000001
101101110111011101110111011101
100000000000C00000000000000001
100000000000000000T00000000001
100000000000000000000000000001
101101110111011101110111011101
100000000000000000000000000001
1000000T000000T00C000000000001
100000000000000000000000000001
101101110111011101110111011101
1000000000000000000000000000T1
10000000T000000000000000000TE1
111111111111111111111111111111