11111111111111111111
10000000000000000001
10C00000000000000001
10000000000000000001
10000000000000000001
10000000000000000T01
10000000000000000001
10000000000000000001
100E0T00000000000001
10000000000000000001
10000000000000000001
1T000000000000000001
1000000C000000000001
100000000000000000T1
10000000000000000001
10000000000000000001
10000000000000CT0001
100000000000000000T1
1000000000000T000001
100T000C000000000001
10000000000000000001
100000C000000000T001
1000000000000000P001
100000000T0000000001
11111111111111111111