1111111111
1010001001
1P1000C001
1000001001
1011101001
1000101111
1111100001
10000010E1
1111111001
1111111111