1111111111
1TPT11T1T1
1TTTT1TTT1
1TTTTTTTT1
1CTTT11111
1TTTTTTTC1
1TTTT11T11
1TTTTTTTT1
1TTT1TTTT1
1TT111TTT1
1TTT1TTTE1
1111111111