1111111111
1000000001
1000000001
1000000001
1000000001
1P00C00001
1000000001
10C0C00001
10000000C1
1000000001
1000000001
1000E00001
10C0000001
100C000001
1111111111