1111111111
1000000001
100000T001
1000000001
1000000001
1P00000001
1000000001
1000000001
1000000T01
1000000001
1000000001
1000000001
10000C0001
10000000E1
1111111111