111111111111111111111111111111
1P0000000000000000000000000001
101101110111011101110111011101
100000000000000000000000000001
100000000000000000000000000001
100000000000000000000000000001
101101110111011101110111011101
100000000000000000000000000001
100000000000000000000000000001
100000000000000000000000000001
101101110111011101110111011101
100000000000000000000000000001
100000000000C0000C000000000001
100000000000000000000000000001
101101110111011101110111011101
100000000000000000000000000001
100000000000000000000000000001
100000000000000000000000000001
101101110111011101110111011101
100000000000C00000000000000001
100000000000000000000000000001
100000000000000000000000000001
101101110111011101110111011101
100000000000000000000000000001
10000000000000000C000000000001
100000000000000000000000000001
101101110111011101110111011101
100000000000000000000000000001
1000000000000000000000000000E1
111111111111111111111111111111