1111111111
10P0110101
1000010001
1000000001
1C00011111
10000000C1
10T0011011
1000000001
1000100001
1001110001
10001000E1
1111111111