11111
1T0P1
10001
1CE01
11111
