11111111111111
10000P00000011
100000000C00E1
11111111111111